
SO texture/so.xpm
NO texture/no.xpm
WE    texture/we.xpm
EA texture/ea.xpm

  
F 205,100,30
C 225,30,70


111111111111111111
100000000000000001
100000000000000001
100000000000000001
100000000000000001
1000000000N0000001
100000000000000001
111111111111111111

