
SO texture/so.xpm
NO texture/no.xpm
WE    texture/we.xpm
EA texture/ea.xpm

  
F 205,100,30
C 225,30,70

  11111111111111111111111111111
 1000000000110000000000001
1011000001110000000000001
10010000000000000000000011111111
111111111011000001110000000000001
   100000000011000001110111111111111
 11110111111111011100000010001
11110111111111011101010010001
111111001101010111000000100011 111
      10000000000000001100000010001
111111000000000011010100100011 111
11000001110101011111011110N0111
11110111 0110101   101111010011
11111111 1111111 111111111111
11       1     1   11
11 1111111      1 1
11 111111111111111111
11 11               1        1111
11  1111111111111  1       11   1                                                                        
111 11             1      1    1
11  11111 11111111111 1  1 1  1
11  11    1  1        1     1 1
11 111 1111111 1111 111111111 1111111111111111111111
11 11                      1                       1
11 11111111111111111111111111111111111111111111111 1111
11                                                     1
1111111111111111111111111111111111111111111111111111111