
SO textures/so.xpm
NO textures/no.xpm
WE    textures/we.xpm
EA textures/ea.xpm

  
F 205,100,30
C 225,30,70

11111111111111111111111
10000000000000000000001
10000000000001000000001
10000000000000000000001
1000010000000N000000001
10000000000000000000001
10000000000000000000001
10000000000000000000001
11111111111111111111111