
SO textures/so.xpm
NO textures/no.xpm
WE    textures/we.xpm
EA textures/ea.xpm

  
F 205,100,30
C 225,30,70

    111111111
111111111
100N1
11111