SO texture/so.xpm
NO texture/no.xpm
WE texture/we.xpm
EA texture/ea.xpm

  
F 205,100,30
C 225,30,70



111111111111111111111111111111111
110000000000000000000000000000001
110100010000000000000000000010001
110000000000000000110000000100001
110011000100000100000000001000001
1100100101000001000N0000010000001
110010100100000100000000100000001
110010000100000100000000000000001
110010000100000111111000000000001
110000000100000000000000000010001
111111111111111111111111111111111