
SO texture/so.xpm
NO texture/no.xpm
WE    texture/we.xpm
EA texture/ea.xpm

  
F 205,100,30
C 225,30,70





111111111111111111111111111111111111
100000000000000000000000000000000001
100000000000000000000000000000000001
100000000000000000000000000000000001
100000000000000000000000000000000001
100000000000000000000000000000000001
100000000000000000000000000000000001
100000000000000001000000000000000001
100000000100000001000000000000000001
100000000000000000000000000000000001
10000000000010000N000000010000000001
100000000000000000000000000000000001
100000000000000001000001000000000001
100000000000000000000000000000000001
100000000000000000000000000000000001
111111111111111111111111111111111111