
 SO     textures/so.xpm             
    NO textures/no.xpm
WE textures/we.xpm  
EA textures/ea.xpm
C 0,0,0
F 109, 11, 0   



1111111111111111            
10000000N001   1
111111111111




