
 SO     textures/so.xpm             
	NO textures/no.xpm
WE textures/we.xpm  
EA textures/ea.xpm
C 0,0,0
F 109, 11, 0   


111111111111111111111111111
100000000000000000000000001
10000000000000000010100011
1000000000000000010000001
10000000N000000001000001
10000000000000000D00001
1000011100000000010001
1000000000000000010001
111111111111111111111