
 SO     textures/so.xpm             
    NO textures/no.xpm
WE textures/we.xpm  
EA textures/ea.xpm

C 0,0,0
F 109, 11, 0   


            1111111111111111111111111
            1110000000110000000000001
            1111000001110000000000001
            111100000000000E000000001
1111111111110000011100000000000011111
10000000001100000111D1111D1111111
11110111111111011100000010001
1111D111111111011101010010001
11000000110101011100000010001
10000000000000000D00000010001
10000000000000001101010010001
1100000111010101111101111000111
11110111 1110101 101111010001
11111111 1111111 111111111111