
 SO     textures/so.xpm             
    NO textures/no.xpm
WE textures/we.xpm  
EA textures/ea.xpm

C 0,0,0
F 109, 11, 0   


            1111111111111111111111111
            1000000000110000000000001
            1011000001110000000000001
            1001000000000000000000001
1111111111110000011100000000000011111
1000000000110000011101111D1111111
11110111111111011100000010001
11110111111111011101010010001
11000000110101011100000010001
1000000000000000D100000010001
10000000000000001101010010001
11000001110101011111011110N0111
11110111 1110101 101111010001
11111111 1111111 111111111111