SO texture/so.xpm
NO texture/no.xpm
WE texture/we.xpm
EA texture/ea.xpm

  
F 19,11,0
C 19,11,0

1111111111111
1000000000001
1000000000001
11D1101111111
1000000000001
1000000000001
1111111D11111
1000000N00001
1000000000001
1000010000001
1111111111111
