
SO       texture/so.xpm
            NO texture/no.xpm
WE texture/we.xpm
EA texture/ea.xpm

C 0,0,0
F 109, 11, 0   

1111111111
10011000001
101ND000011
1111111111



 