
SO  texture/so.xpm
            NO texture/no.xpm
WE texture/we.xpm
EA texture/ea.xpm

C 0,0,0
F 109, 11, 0   

111111111111111111111111111111111
100000000000000000000000000000001
110100010000000000000000000010001
110000000000000000110000000100001
1100110001000001000N0000001000001
110010010100000100000000010000001
110010100100000D00000000100000001
110010000100000100000000000000001
11001000010000011D111000000000001
110000000100000000000000000010001
111111111111111111111111111111111



 