SO texture/so.xpm
NO texture/no.xpm
WE texture/we.xpm
EA texture/ea.xpm

  
F 19,11,0
C 19,11,0

111111111111111111111111111111111
110000000000000000000000000000001
110100010000000000000000000000001
110000000000000000000000000000001
110011000100000000000100000000001
110010010100000000000000000000001
110010100100000000100000100000001
110010000100000010000000000000001
1100100001000000000N0000000000001
110000000100000000000000000010001
111111111111111111111111111111111